2 2 2 2 12 13 14 12 13 14 12 13 14 12 13 14 12 13 14 12
2 2 2 2 15 16 17 15 16 17 15 16 17 15 16 17 15 16 17 15
11 5 4 9 1 0 1 0 1 0 1 0 1 0 1 0 1 0 1 0
10 4 5 6 0 1 0 1 0 1 0 1 0 1 0 1 0 1 0 1
11 5 4 7 1 0 1 0 1 0 1 0 1 0 1 0 1 0 1 0
10 4 5 8 0 1 0 1 0 1 0 1 0 1 0 1 0 1 0 1
11 5 4 7 1 0 1 0 1 0 1 0 1 0 1 0 1 0 1 0
10 4 5 6 0 1 0 1 0 1 0 1 0 1 0 1 0 1 0 1
11 5 4 9 1 0 1 0 1 0 1 0 1 0 1 0 1 0 1 0
10 4 5 6 0 1 0 1 0 1 0 1 0 1 0 1 0 1 0 1
11 5 4 9 1 0 1 0 1 0 1 0 1 0 1 0 1 0 1 0
10 4 5 8 0 1 0 1 0 1 0 1 0 1 0 1 0 1 0 1
2 2 2 2 12 13 14 12 13 14 12 13 14 12 13 14 12 13 14 12
2 2 2 2 15 16 17 15 16 17 15 16 17 15 16 17 15 16 17 15 
