11 20 21 20 21 6 12 13 14 12 13 14 12 13 14 12 13 14 12 13 14 12 12 13
10 4 5 4 5 7 15 16 17 15 16 17 15 16 17 15 16 17 15 16 17 15 15 16
11 5 4 5 4 9 1 0 1 0 1 0 1 0 1 0 1 0 1 0 1 0 1 0
10 4 5 4 5 6 0 1 0 1 0 1 0 1 0 1 0 1 0 1 0 1 0 1
11 5 4 5 4 7 1 0 1 0 1 0 1 0 1 0 1 0 1 0 1 0 1 0
10 4 5 4 5 8 0 1 0 1 0 1 0 1 0 1 0 1 0 1 0 1 0 1
11 5 4 5 4 7 1 0 1 0 1 0 1 0 1 0 1 0 1 0 1 0 1 0
10 4 5 4 5 6 0 1 0 1 0 1 0 1 0 1 0 1 0 1 0 1 0 1
11 5 4 5 4 9 1 0 1 0 1 0 1 0 1 0 1 0 1 0 1 0 1 0
10 4 5 4 5 6 0 1 0 1 0 1 0 1 0 1 0 1 0 1 0 1 0 1
11 5 4 5 4 9 1 0 1 0 1 0 1 0 1 0 1 0 1 0 1 0 1 0
10 4 5 4 5 8 0 1 0 1 0 1 0 1 0 1 0 1 0 1 0 1 0 1
11 5 4 4 5 6 12 13 14 12 13 14 12 13 14 12 13 14 12 13 14 12 12 13
10 18 19 18 19 7 15 16 17 15 16 17 15 16 17 15 16 17 15 16 17 15 15 16
